/////////////////////////////////////////////////
/////////////////////////////////////////////////
/////////////////////////////////////////////////
/////////////////////////////////////////////////
/////////////////////////////////////////////////
/////////////////////////////////////////////////
/////////////////////////////////////////////////
/////////////////////////////////////////////////
////////////////////////////////////////////1////
///////000000000000000000000000000000000000000000
/////////////////////////////////////////////////
/////////////////////////////////////////////////
/////////////////////////////////////////////////
/////////////////////////////////////////////////
/////////////////////////////////////////////////
/////////////////////////////////////////////////
/////////////////////////////////////////////////
/////////////////////////////////////////////////
/////////////////////////////////////////////////
/1///1////////////////////////////////////////////
00000000000000000000000000000000000000000////////
/////////////////////////////////////////////////
/////////////////////////////////////////////////
/////////////////////////////////////////////////
/////////////////////////////////////////////////
/////////////////////////////////////////////////
/////////////////////////////////////////////////
/////////////////////////////////////////////////
/////////////////////////////////////////////////
/////////////////////////////////////////////////