/////////////////////////////////////////////////
/////////////////////////////////////////////////
/////////////////////////////////////////////////
/////////////////////////////////////////////////
/////////////////////////////////////////////////
/////////////////////////////////////////5///////
/////////////////////////////////////////////////
/////////////////////////////////////////////////
/////////////////////////////////////////////////
///////////40000000000000000000000000000000000000
/////////////////////////////////////////////////
/////////////////////////////////////////////////
/////////////////////////////////////////////////
/////////////////////////////////////////////////
/////////////////////////////////////////////////
/////////////////////////////////////////////////
/////////////////////////////////////////////////
/////////////////////////////////////////////////
//3//////////////////////////////////////////////
/////////////////////////////////////////////////
00000000000000000000000000000000000000004////////
/////////////////////////////////////////////////
/////////////////////////////////////////////////
/////////////////////////////////////////////////
/////////////////////////////////////////////////
0000000000000000000000000000000000000000000000000
0000000000000000000000000000000000000000000000000
/////////////////////////////////////////////////
/////////////////////////////////////////////////
/////////////////////////////////////////////////